#################################################
#*...............................#........#.....#
#................................#........#.....#
#..############################..#..####..#..####
#..............#...........#.....#.....#..#.....#
#..............#...........#.....#.....#..#.....#
###################..#..####..####..#..#..#..#..#
#...........#........#..#.....#.....#..#..#..#..#
#...........#........#..#.....#.....#..#..#..#..#
#..#..#######..#..####..#..####..####..#..####..#
#..#...........#.....#..#..#.....#.....#........#
#..#...........#.....#..#..#.....#.....#........#
#..################..#..#..#..####..#..##########
#..#........#.....#..#..#..#..#.....#..#........#
#..#........#.....#..#..#..#..#.....#..#........#
#..#######..#..#..#..####..#..#..#######..####..#
#.....#.....#..#.....#.....#..#..#........#.....#
#.....#.....#..#.....#.....#..#..#........#.....#
####..#..####..####..#..####..#..#..#######..#..#
#..#..#.....#.....#..#.....#..#...........#..#..#
#..#..#.....#.....#..#.....#..#...........#..#..#
#..#..####..####..#######..################..#..#
#..............#.............................#..#
#..............#.............................#..#
#################################################
